AAABBBCCC
AAABBBCCC
AAABBBCCC
DDDEEEFFF
DDDEEEFFF
DDDEEEFFF
GGGHHHAAA
GGGHHHAAA
GGGHHHAAA